111111111111111111
123000010000010001
100000010000010001
100000010000010001
100000010000010001
100000010000010001
100000010000010001
100000010000010001
100000000000010001
100000010000010001
111111111101111011
100000000000010001
100000000000000001
100000000000010001
111111111111111111